072
###########
--#------#-
-----------
-----------
-----------
A,J,D
